▀	⚐	▀	▀	▀	▀	▀
▀	☐	▀	☐	☐	☐	▀
▀	☐	▀	☐	▀	☐	▀
▀	☐	▀	☐	▀	☐	▀
▀	☐	▀	☐	▀	☐	▀
▀	☐	▀	⚑	▀	☐	▀
▀	☐	▀	▀	▀	☐	▀
▀	☐	☐	☐	☐	☐	▀
▀	▀	▀	▀	▀	▀	▀